5
1 2 3 1 1
1 3 4 1 1
1 1 3 1 4
1 3 4 2 2
3 1 3 1 0
